13x32





111 11113 311
111 11113 311
111 11113 311
111 11113 311
111 11113 311
111 11113 311
111 11113 311
111 11113 311
111 11113 311
111 11113 311
111 11113 311
111 11113 311
111333333 311
333       333
333       333
113       311
113 333333111
113 311113111