13x32





1111111111111
2222222222222
3333333333333
1 1 1 1 1 1 1
 1 1 1 1 1 1
1111111111111


1111   111111